11111111111111111111111
100000E0000000000P00001
10000000000000000000001
11111111111111111111111