1111111111
1C00000001
1P000C0000000001
10000000E1111
1111111111