111111111111111111111111111
1P000000000000000E0000000C1
111111111111111111111111111
