111111111111111111
10000000P000C00001
100000000000000001
111111111111111111