111111111111111111111111111
1P00000000000000000000000C1
1000000000000000000000000E1
111111111111111111111111111