111111111111111111111111111
10000000000P000000000000111
1000000000C0C000000000001E1
111111111111111111111111111
