


111111111111111111111111111
10000000000P000000000000001
1000000000C0C000000000000E1

111111111111111111111111111


